EEEEEEEEEEEESRHHHHRE
EEETREEEEEEEFRHHHHRE
EEEWRCCCCIIIIRHHHHRE
EEEPRCCCCIIIIRHHHHRD
RRRRRRRRRRRRRRRRRRRR
EEESRCCHHRIIEERSHHRE
EEETRCCHHRIIEERFHHRE
EEEWRCCHHRIIEERDCCRE
EEEPRCCHHRIIEERHCCRE
RRRRRRRRRRRRRRRRRRRE